1	1	1	1	1	1	1	1	1	1	1	1	1
1	3	0	0	0	15	0	75	80	13	1	7	1
1	1	1	1	1	1	0	75	10	80	1	110	1
1	25	1	10	5	1	0	75	10	85	1	120	1
1	120	1	12	90	15	0	75	85	12	1	95	1
1	105	1	13	5	1	15	1	1	1	1	105	1
1	90	1	1	1	1	0	5	75	10	1	90	1
1	85	80	75	16	15	0	0	0	75	1	85	1
1	1	1	1	1	1	1	1	1	15	1	80	1
1	0	0	0	0	80	85	80	10	0	16	75	1
1	15	1	1	1	1	1	1	1	1	1	1	1
1	0	0	0	10	75	85	75	12	13	0	4	1
1	1	1	1	1	1	1	1	1	1	1	1	1
