1	1	1	1	1	1	1	1	1	1	1	1	1
1	4	0	0	0	50	51	50	0	0	0	10	1
1	1	1	1	1	1	1	1	1	1	1	15	1
1	0	0	0	0	55	55	55	0	0	0	10	1
1	0	1	1	1	1	1	1	1	1	1	1	1
1	0	1	58	15	0	0	0	0	0	15	0	1
1	0	1	5	1	0	1	1	1	0	1	53	1
1	0	1	1	1	0	1	12	1	0	1	13	1
1	0	0	0	15	0	1	53	15	0	1	12	1
1	1	15	1	1	1	1	10	1	0	1	45	1
1	0	58	0	1	6	1	1	1	0	1	1	1
1	13	12	5	1	5	13	58	15	0	17	3	1
1	1	1	1	1	1	1	1	1	1	1	1	1
