1	1	1	1	1	1	1	1	1	1	1	1	1
1	3	0	0	49	50	49	0	1	3	51	50	1
1	1	1	1	1	1	1	0	1	1	1	49	1
1	0	52	51	50	49	15	0	16	52	1	15	1
1	1	15	1	1	1	1	0	1	13	1	0	1
1	5	55	5	1	52	15	0	1	12	1	0	1
1	1	15	1	1	12	1	0	1	10	1	0	1
1	13	55	12	1	1	1	0	1	1	1	0	1
1	5	10	5	1	0	0	0	0	0	0	0	1
1	1	15	1	1	1	0	1	1	1	16	1	1
1	12	58	13	1	0	0	0	1	5	58	5	1
1	6	10	5	1	0	0	0	1	5	5	5	1
1	1	1	1	1	1	1	1	1	1	1	1	1
