1	1	1	1	1	1	1	1	1	1	1	1	1
1	4	0	0	0	0	0	0	1	4	0	0	1
1	1	1	1	1	1	1	0	1	1	1	20	1
1	0	0	0	1	0	0	0	5	5	1	1	1
1	12	0	13	35	0	1	1	1	1	1	12	1
1	0	0	10	1	0	0	1	5	5	1	13	1
1	1	1	1	1	0	0	15	0	13	1	0	1
1	5	6	10	1	0	0	1	1	1	1	0	1
1	5	0	0	15	0	0	15	0	5	1	0	1
1	1	1	1	1	0	0	1	12	1	1	15	1
1	5	6	10	1	0	0	1	1	1	5	0	1
1	5	0	0	15	0	0	0	0	15	0	2	1
1	1	1	1	1	1	1	1	1	1	1	1	1
