1	1	1	1	1	1	1	1	1	1	1	1	1
1	4	0	0	49	50	49	0	1	4	0	55	1
1	1	1	1	1	1	1	0	1	1	1	20	1
1	41	40	42	1	0	0	0	5	5	1	1	1
1	12	0	13	15	0	1	1	1	1	1	12	1
1	10	0	10	1	0	49	1	5	5	1	13	1
1	1	1	1	1	0	50	15	58	13	1	51	1
1	5	6	10	1	0	51	1	1	1	1	50	1
1	5	0	52	15	0	50	15	55	5	1	49	1
1	1	1	1	1	0	49	1	12	1	1	15	1
1	5	6	10	1	0	0	1	1	1	5	0	1
1	5	0	55	15	0	0	0	0	15	0	2	1
1	1	1	1	1	1	1	1	1	1	1	1	1
