1	1	1	1	1	1	1	1	1	1	1	1	1
1	3	0	0	0	15	0	49	50	13	1	7	1
1	1	1	1	1	1	0	49	10	50	1	56	1
1	25	1	10	5	1	0	49	10	51	1	58	1
1	58	1	12	52	15	0	49	51	12	1	53	1
1	55	1	13	5	1	15	1	1	1	1	55	1
1	52	1	1	1	1	0	5	49	10	1	52	1
1	51	50	49	16	15	0	0	0	49	1	51	1
1	1	1	1	1	1	1	1	1	15	1	50	1
1	0	0	0	0	50	51	50	10	0	16	49	1
1	15	1	1	1	1	1	1	1	1	1	1	1
1	0	0	0	10	49	51	49	12	13	0	4	1
1	1	1	1	1	1	1	1	1	1	1	1	1
