1	1	1	1	1	1	1	1	1	1	1	1	1
1	3	0	0	75	80	75	0	1	3	85	80	1
1	1	1	1	1	1	1	0	1	1	1	75	1
1	0	90	85	80	75	15	0	16	90	1	15	1
1	1	15	1	1	1	1	0	1	13	1	0	1
1	5	105	5	1	90	15	0	1	12	1	0	1
1	1	15	1	1	12	1	0	1	10	1	0	1
1	13	105	12	1	1	1	0	1	1	1	0	1
1	5	10	5	1	0	0	0	0	0	0	0	1
1	1	15	1	1	1	0	1	1	1	16	1	1
1	12	120	13	1	0	0	0	1	5	120	5	1
1	6	10	5	1	0	0	0	1	5	5	5	1
1	1	1	1	1	1	1	1	1	1	1	1	1
