1	1	1	1	1	1	1	1	1	1	1	1	1
1	4	0	0	75	80	75	0	1	4	0	105	1
1	1	1	1	1	1	1	0	1	1	1	20	1
1	42	40	43	1	0	0	0	5	5	1	1	1
1	12	0	13	15	0	1	1	1	1	1	12	1
1	10	0	10	1	0	75	1	5	5	1	13	1
1	1	1	1	1	0	80	15	120	13	1	85	1
1	5	6	10	1	0	85	1	1	1	1	80	1
1	5	0	90	15	0	80	15	105	5	1	75	1
1	1	1	1	1	0	75	1	12	1	1	15	1
1	5	6	10	1	0	0	1	1	1	5	0	1
1	5	0	105	15	0	0	0	0	15	0	2	1
1	1	1	1	1	1	1	1	1	1	1	1	1
