1	1	1	1	1	1	1	1	1	1	1	1	1
1	4	0	0	0	80	85	80	0	0	0	10	1
1	1	1	1	1	1	1	1	1	1	1	15	1
1	0	0	0	0	105	105	105	0	0	0	10	1
1	0	1	1	1	1	1	1	1	1	1	1	1
1	0	1	120	15	0	0	0	0	0	15	0	1
1	0	1	5	1	0	1	1	1	0	1	95	1
1	0	1	1	1	0	1	12	1	0	1	13	1
1	0	0	0	15	0	1	95	15	0	1	12	1
1	1	15	1	1	1	1	10	1	0	1	45	1
1	0	120	0	1	6	1	1	1	0	1	1	1
1	13	12	5	1	5	13	120	15	0	17	3	1
1	1	1	1	1	1	1	1	1	1	1	1	1
