1	1	1	1	1	1	1	1	1	1	1	1	1
1	3	0	0	0	0	0	5	1	3	0	0	1
1	1	1	1	1	1	1	0	1	1	1	0	1
1	6	7	8	0	0	5	0	0	0	1	0	1
1	1	0	1	1	1	1	0	1	0	1	0	1
1	0	0	50	1	49	0	0	1	0	1	0	1
1	1	0	1	1	0	1	0	1	0	1	0	1
1	0	0	0	1	1	1	0	1	1	1	0	1
1	0	0	0	1	41	40	42	0	0	0	0	1
1	1	0	1	1	1	0	1	1	1	0	1	1
1	0	0	0	1	49	0	0	1	0	0	0	1
1	0	0	0	1	0	0	0	1	0	0	0	1
1	1	1	1	1	1	1	1	1	1	1	1	1
