1	1	1	1	1	1	1	1	1	1	1	1	1
1	3	0	0	0	0	0	5	1	3	0	0	1
1	1	1	1	1	1	1	0	1	1	1	0	1
1	6	7	8	0	0	5	0	0	0	1	0	1
1	1	0	1	1	1	1	0	1	0	1	0	1
1	0	0	31	1	35	0	0	1	0	1	0	1
1	1	0	1	1	0	1	0	1	0	1	0	1
1	0	0	0	1	1	1	0	1	1	1	0	1
1	0	0	0	1	0	0	0	0	0	0	0	1
1	1	0	1	1	1	0	1	1	1	0	1	1
1	0	0	0	1	31	0	0	1	0	0	0	1
1	0	0	0	1	0	0	0	1	0	0	0	1
1	1	1	1	1	1	1	1	1	1	1	1	1
